{
  "tileMap": [
    [105, 106, 107, 108, 109, 105, 106, 107, 108, 109, 105, 106, 107, 108, 109, 105, 106, 107, 108, 109],
    [125, 126, 127, 128, 129, 125, 126, 127, 128, 129, 125, 126, 127, 128, 129, 125, 126, 127, 128, 129],
    [-1, -1, -1, -1, -1, -1, -1, -1, -1, -1, -1, -1, -1, -1, -1, -1, -1, -1, -1, -1],
    [-1, -1, -1, -1, -1, -1, -1, -1, 186, 187, 188, -1, -1, -1, -1, -1, -1, -1, -1, -1],
    [-1, -1, -1, -1, -1, -1, -1, -1, -1, -1, -1, -1, -1, -1, -1, -1, -1, -1, -1, -1],
    [-1, -1, -1, -1, -1, -1, -1, -1, -1, 205, 206, 207, 208, 209, -1, -1, -1, -1, -1, -1],
    [-1, -1, -1, -1, -1, -1, -1, -1, -1, -1, -1, -1, -1, -1, -1, -1, -1, -1, -1, -1],
    [-1, -1, -1, -1, -1, -1, -1, -1, -1, -1, -1, -1, -1, -1, 297, -1, 297, -1, -1, -1],
    [14, 14, 14, 14, 14, -1, -1, -1, 12, -1, -1, -1, -1, -1, 18, 12, 15, 14, 15, 16],
    [34, 34, 34, 34, 34, -1, -1, -1, -1, -1, -1, -1, -1, -1, 38, 32, 34, 34, 34, 34],
    [93, 93, 93, 93, 93, 6, 6, 6, 6, 6, 6, 6, 6, 6, 7, 8, 93, 93, 93, 93],
    [-1, -1, -1, -1, -1, -1, -1, -1, -1, -1, -1, -1, -1, -1, -1, -1, -1, -1, -1, -1]
  ]
}